"deliveryId","lodgementId","Delivery Date","Lot Number","Delivered Bags","Balance Bags","Months Lodged","Total Charges Paid","Rent Receivable on Delivered Bags"
"6433da348a12e9ad0dd6b90e","643373178a12e9ad0d2fa451","04/01/2020","2525/589","15","108","0 Months","79","0"
"6433da348a12e9ad0dd6b90f","643373178a12e9ad0d2fa451","06/01/2020","2525/589","10","98","0 Months","52","0"
"6433da348a12e9ad0dd6b910","643373178a12e9ad0d2fa451","18/01/2020","2525/589","4","94","0 Months","21","0"
"6433da348a12e9ad0dd6b911","643373178a12e9ad0d2fa451","18/01/2020","2525/589","10","84","0 Months","52","0"
"6433da348a12e9ad0dd6b912","643373178a12e9ad0d2fa451","22/01/2020","2525/589","10","74","0 Months","52","0"
"6433da348a12e9ad0dd6b913","643373178a12e9ad0d2fa451","25/01/2020","2525/589","20","54","0 Months","105","0"
"6433da348a12e9ad0dd6b914","643373178a12e9ad0d2fa451","29/01/2020","2525/589","20","34","0 Months","105","0"
"6433da348a12e9ad0dd6b915","643373178a12e9ad0d2fa451","02/02/2020","2525/589","10","24","0 Months","52","0"
"6433da348a12e9ad0dd6b916","643373178a12e9ad0d2fa451","07/02/2020","2525/589","24","0","0 Months","126","0"
"6433da348a12e9ad0dd6b917","643373178a12e9ad0d2fa452","07/02/2020","4025/807","21","786","0 Months","59","0"
"6433da348a12e9ad0dd6b918","643373178a12e9ad0d2fa452","09/02/2020","4025/807","36","750","0 Months","102","0"
"6433da348a12e9ad0dd6b919","643373178a12e9ad0d2fa452","09/02/2020","4025/807","72","678","0 Months","203","0"
"6433da348a12e9ad0dd6b91a","643373178a12e9ad0d2fa452","12/02/2020","4025/807","8","670","0 Months","22","0"
"6433da348a12e9ad0dd6b91b","643373178a12e9ad0d2fa452","13/02/2020","4025/807","72","598","0 Months","203","0"
"6433da348a12e9ad0dd6b91c","643373178a12e9ad0d2fa452","14/02/2020","4025/807","72","526","0 Months","203","0"
"6433da348a12e9ad0dd6b91d","643373178a12e9ad0d2fa452","14/02/2020","4025/807","55","471","0 Months","155","0"
"6433da348a12e9ad0dd6b91e","643373178a12e9ad0d2fa452","15/02/2020","4025/807","72","399","0 Months","203","0"
"6433da348a12e9ad0dd6b91f","643373178a12e9ad0d2fa452","15/02/2020","4025/807","9","390","0 Months","25","0"
"6433da348a12e9ad0dd6b920","643373178a12e9ad0d2fa452","16/02/2020","4025/807","72","318","0 Months","203","0"
"6433da348a12e9ad0dd6b921","643373178a12e9ad0d2fa452","28/02/2020","4025/807","30","288","0 Months","84","0"
"6433da348a12e9ad0dd6b922","643373178a12e9ad0d2fa452","28/02/2020","4025/807","30","258","0 Months","84","0"
"6433da348a12e9ad0dd6b923","643373178a12e9ad0d2fa452","05/03/2020","4025/807","30","228","0 Months","84","0"
"6433da348a12e9ad0dd6b924","643373178a12e9ad0d2fa452","06/03/2020","4025/807","60","168","0 Months","169","0"
"6433da348a12e9ad0dd6b925","643373178a12e9ad0d2fa452","13/03/2020","4025/807","60","108","0 Months","169","0"
"6433da348a12e9ad0dd6b926","643373178a12e9ad0d2fa452","20/03/2020","4025/807","50","58","0 Months","141","0"
"6433da348a12e9ad0dd6b927","643373178a12e9ad0d2fa452","19/04/2020","4025/807","30","28","0 Months","54","0"
"6433da348a12e9ad0dd6b928","643373178a12e9ad0d2fa452","15/05/2020","4025/807","28","0","0 Months","78","0"
"6433da348a12e9ad0dd6b929","643373178a12e9ad0d2fa453","01/06/2020","4571/201","2","199","0 Months","17","0"
"6433da348a12e9ad0dd6b92a","643373178a12e9ad0d2fa453","11/06/2020","4571/201","2","197","0 Months","20","0"
"6433da348a12e9ad0dd6b92b","643373178a12e9ad0d2fa453","06/07/2020","4571/201","1","196","0 Months","6","0"
"6433da348a12e9ad0dd6b92c","643373178a12e9ad0d2fa453","31/07/2020","4571/201","2","194","0 Months","8","0"
"6433da348a12e9ad0dd6b92d","643373178a12e9ad0d2fa453","11/08/2020","4571/201","1","193","0 Months","8","0"
"6433da348a12e9ad0dd6b92e","643373178a12e9ad0d2fa453","20/08/2020","4571/201","1","192","0 Months","10","0"
"6433da348a12e9ad0dd6b92f","643373178a12e9ad0d2fa453","31/08/2020","4571/201","1","191","0 Months","8","0"
"6433da348a12e9ad0dd6b930","643373178a12e9ad0d2fa453","11/09/2020","4571/201","1","190","0 Months","6","0"
"6433da348a12e9ad0dd6b931","643373178a12e9ad0d2fa453","25/09/2020","4571/201","2","188","0 Months","22","0"
"6433da348a12e9ad0dd6b932","643373178a12e9ad0d2fa453","28/09/2020","4571/201","2","186","0 Months","11","0"
"6433da348a12e9ad0dd6b933","643373178a12e9ad0d2fa453","09/10/2020","4571/201","1","185","0 Months","11","0"
"6433da348a12e9ad0dd6b934","643373178a12e9ad0d2fa453","16/10/2020","4571/201","1","184","0 Months","11","0"
"6433da348a12e9ad0dd6b935","643373178a12e9ad0d2fa453","26/10/2020","4571/201","2","182","0 Months","11","0"
"6433da348a12e9ad0dd6b936","643373178a12e9ad0d2fa453","29/10/2020","4571/201","1","181","0 Months","11","0"
"6433da348a12e9ad0dd6b937","643373178a12e9ad0d2fa453","02/11/2020","4571/201","1","180","0 Months","11","0"
"6433da348a12e9ad0dd6b938","643373178a12e9ad0d2fa453","09/11/2020","4571/201","2","178","0 Months","11","0"
"6433da348a12e9ad0dd6b939","643373178a12e9ad0d2fa453","12/11/2020","4571/201","1","177","0 Months","11","0"
"6433da348a12e9ad0dd6b93a","643373178a12e9ad0d2fa453","19/11/2020","4571/201","1","176","0 Months","11","0"
"6433da348a12e9ad0dd6b93b","643373178a12e9ad0d2fa453","22/11/2020","4571/201","10","166","0 Months","137","0"
"6433da348a12e9ad0dd6b93c","643373178a12e9ad0d2fa453","23/11/2020","4571/201","1","165","0 Months","11","0"
"6433da348a12e9ad0dd6b93d","643373178a12e9ad0d2fa453","25/11/2020","4571/201","1","164","0 Months","11","0"
"6433da348a12e9ad0dd6b93e","643373178a12e9ad0d2fa453","30/11/2020","4571/201","1","163","0 Months","11","0"
"6433da348a12e9ad0dd6b93f","643373178a12e9ad0d2fa453","10/12/2020","4571/201","1","162","0 Months","11","0"
"6433da348a12e9ad0dd6b940","643373178a12e9ad0d2fa453","25/12/2020","4571/201","1","161","0 Months","11","0"
"6433da348a12e9ad0dd6b941","643373178a12e9ad0d2fa453","31/12/2020","4571/201","1","160","0 Months","11","0"
"6433da348a12e9ad0dd6b942","643373178a12e9ad0d2fa453","08/01/2021","4571/201","1","159","0 Months","11","0"
"6433da348a12e9ad0dd6b943","643373178a12e9ad0d2fa453","11/01/2021","4571/201","1","158","0 Months","11","0"
"6433da348a12e9ad0dd6b944","643373178a12e9ad0d2fa453","18/01/2021","4571/201","2","156","0 Months","13","0"
"6433da348a12e9ad0dd6b945","643373178a12e9ad0d2fa453","21/01/2021","4571/201","1","155","0 Months","11","0"
"6433da348a12e9ad0dd6b946","643373178a12e9ad0d2fa453","21/01/2021","4571/201","4","151","0 Months","45","0"
"6433da348a12e9ad0dd6b947","643373178a12e9ad0d2fa453","28/01/2021","4571/201","1","150","0 Months","11","0"
"6433da348a12e9ad0dd6b948","643373178a12e9ad0d2fa453","04/02/2021","4571/201","1","149","0 Months","11","0"
"6433da348a12e9ad0dd6b949","643373178a12e9ad0d2fa453","04/02/2021","4571/201","1","148","0 Months","0","0"
"6433da348a12e9ad0dd6b94a","643373178a12e9ad0d2fa453","11/02/2021","4571/201","1","147","0 Months","11","0"
"6433da348a12e9ad0dd6b94b","643373178a12e9ad0d2fa453","15/02/2021","4571/201","1","146","0 Months","11","0"
"6433da348a12e9ad0dd6b94c","643373178a12e9ad0d2fa453","19/02/2021","4571/201","1","145","0 Months","11","0"
"6433da348a12e9ad0dd6b94d","643373178a12e9ad0d2fa453","22/02/2021","4571/201","8","137","0 Months","91","0"
"6433da348a12e9ad0dd6b94e","643373178a12e9ad0d2fa453","22/02/2021","4571/201","1","136","0 Months","11","0"
"6433da348a12e9ad0dd6b94f","643373178a12e9ad0d2fa453","05/03/2021","4571/201","2","134","0 Months","22","0"
"6433da348a12e9ad0dd6b950","643373178a12e9ad0d2fa453","12/03/2021","4571/201","1","133","0 Months","11","0"
"6433da348a12e9ad0dd6b951","643373178a12e9ad0d2fa453","19/03/2021","4571/201","1","132","0 Months","11","0"
"6433da348a12e9ad0dd6b952","643373178a12e9ad0d2fa453","22/03/2021","4571/201","10","122","0 Months","114","0"
"6433da348a12e9ad0dd6b953","643373178a12e9ad0d2fa453","29/03/2021","4571/201","1","121","0 Months","11","0"
"6433da348a12e9ad0dd6b954","643373178a12e9ad0d2fa453","01/04/2021","4571/201","1","120","0 Months","11","0"
"6433da348a12e9ad0dd6b955","643373178a12e9ad0d2fa453","06/04/2021","4571/201","1","119","0 Months","11","0"
"6433da348a12e9ad0dd6b956","643373178a12e9ad0d2fa453","16/04/2021","4571/201","1","118","0 Months","11","0"
"6433da348a12e9ad0dd6b957","643373178a12e9ad0d2fa453","22/04/2021","4571/201","1","117","0 Months","11","0"
"6433da348a12e9ad0dd6b958","643373178a12e9ad0d2fa453","03/05/2021","4571/201","1","116","0 Months","9","0"
"6433da348a12e9ad0dd6b959","643373178a12e9ad0d2fa453","03/06/2021","4571/201","1","115","0 Months","11","0"
"6433da348a12e9ad0dd6b95a","643373178a12e9ad0d2fa453","07/06/2021","4571/201","1","114","0 Months","10","0"
"6433da348a12e9ad0dd6b95b","643373178a12e9ad0d2fa453","17/06/2021","4571/201","1","113","0 Months","10","0"
"6433da348a12e9ad0dd6b95c","643373178a12e9ad0d2fa453","21/06/2021","4571/201","1","112","0 Months","10","0"
"6433da348a12e9ad0dd6b95d","643373178a12e9ad0d2fa453","28/06/2021","4571/201","1","111","0 Months","10","0"
"6433da348a12e9ad0dd6b95e","643373178a12e9ad0d2fa453","30/06/2021","4571/201","10","101","0 Months","115","0"
"6433da348a12e9ad0dd6b95f","643373178a12e9ad0d2fa453","05/07/2021","4571/201","1","100","0 Months","10","0"
"6433da348a12e9ad0dd6b960","643373178a12e9ad0d2fa453","09/07/2021","4571/201","1","99","0 Months","10","0"
"6433da348a12e9ad0dd6b961","643373178a12e9ad0d2fa453","23/07/2021","4571/201","1","98","0 Months","10","0"
"6433da348a12e9ad0dd6b962","643373178a12e9ad0d2fa453","29/07/2021","4571/201","1","97","0 Months","10","0"
"6433da348a12e9ad0dd6b963","643373178a12e9ad0d2fa453","02/08/2021","4571/201","1","96","0 Months","10","0"
"6433da348a12e9ad0dd6b964","643373178a12e9ad0d2fa453","05/08/2021","4571/201","1","95","0 Months","10","0"
"6433da348a12e9ad0dd6b965","643373178a12e9ad0d2fa453","14/08/2021","4571/201","1","94","0 Months","10","0"
"6433da348a12e9ad0dd6b966","643373178a12e9ad0d2fa453","16/08/2021","4571/201","2","92","0 Months","20","0"
"6433da348a12e9ad0dd6b967","643373178a12e9ad0d2fa453","18/08/2021","4571/201","1","91","0 Months","10","0"
"6433da348a12e9ad0dd6b968","643373178a12e9ad0d2fa453","23/08/2021","4571/201","1","90","0 Months","10","0"
"6433da348a12e9ad0dd6b969","643373178a12e9ad0d2fa453","26/08/2021","4571/201","1","89","0 Months","10","0"
"6433da348a12e9ad0dd6b96a","643373178a12e9ad0d2fa453","26/08/2021","4571/201","6","83","0 Months","70","0"
"6433da348a12e9ad0dd6b96b","643373178a12e9ad0d2fa453","27/08/2021","4571/201","1","82","0 Months","10","0"
"6433da348a12e9ad0dd6b96c","643373178a12e9ad0d2fa453","03/09/2021","4571/201","1","81","0 Months","10","0"
"6433da348a12e9ad0dd6b96d","643373178a12e9ad0d2fa453","08/09/2021","4571/201","1","80","0 Months","10","0"
"6433da348a12e9ad0dd6b96e","643373178a12e9ad0d2fa453","11/09/2021","4571/201","6","74","0 Months","70","0"
"6433da348a12e9ad0dd6b96f","643373178a12e9ad0d2fa453","20/09/2021","4571/201","1","73","0 Months","10","0"
"6433da348a12e9ad0dd6b970","643373178a12e9ad0d2fa453","22/09/2021","4571/201","6","67","0 Months","70","0"
"6433da348a12e9ad0dd6b971","643373178a12e9ad0d2fa453","04/10/2021","4571/201","1","66","0 Months","10","0"
"6433da348a12e9ad0dd6b972","643373178a12e9ad0d2fa453","11/10/2021","4571/201","1","65","0 Months","10","0"
"6433da348a12e9ad0dd6b973","643373178a12e9ad0d2fa453","21/10/2021","4571/201","1","64","0 Months","10","0"
"6433da348a12e9ad0dd6b974","643373178a12e9ad0d2fa453","25/10/2021","4571/201","6","58","0 Months","70","0"
"6433da348a12e9ad0dd6b975","643373178a12e9ad0d2fa453","03/11/2021","4571/201","1","57","0 Months","10","0"
"6433da348a12e9ad0dd6b976","643373178a12e9ad0d2fa453","05/11/2021","4571/201","1","56","0 Months","10","0"
"6433da348a12e9ad0dd6b977","643373178a12e9ad0d2fa453","08/11/2021","4571/201","1","55","0 Months","0","0"
"6433da348a12e9ad0dd6b978","643373178a12e9ad0d2fa453","11/11/2021","4571/201","5","50","0 Months","55","0"
"6433da348a12e9ad0dd6b979","643373178a12e9ad0d2fa453","14/11/2021","4571/201","1","49","0 Months","10","0"
"6433da348a12e9ad0dd6b97a","643373178a12e9ad0d2fa453","22/11/2021","4571/201","1","48","0 Months","10","0"
"6433da348a12e9ad0dd6b97b","643373178a12e9ad0d2fa453","22/11/2021","4571/201","2","46","0 Months","20","0"
"6433da348a12e9ad0dd6b97c","643373178a12e9ad0d2fa453","24/11/2021","4571/201","8","38","0 Months","90","0"
"6433da348a12e9ad0dd6b97d","643373178a12e9ad0d2fa453","25/11/2021","4571/201","1","37","0 Months","10","0"
"6433da348a12e9ad0dd6b97e","643373178a12e9ad0d2fa453","02/12/2021","4571/201","1","36","0 Months","10","0"
"6433da348a12e9ad0dd6b97f","643373178a12e9ad0d2fa453","06/12/2021","4571/201","10","26","0 Months","115","0"
"6433da348a12e9ad0dd6b980","643373178a12e9ad0d2fa453","10/12/2021","4571/201","1","25","0 Months","10","0"
"6433da348a12e9ad0dd6b981","643373178a12e9ad0d2fa453","16/12/2021","4571/201","1","24","0 Months","10","0"
"6433da348a12e9ad0dd6b982","643373178a12e9ad0d2fa453","23/12/2021","4571/201","1","23","0 Months","10","0"
"6433da348a12e9ad0dd6b983","643373178a12e9ad0d2fa453","27/12/2021","4571/201","1","22","0 Months","10","0"
"6433da348a12e9ad0dd6b984","643373178a12e9ad0d2fa453","30/12/2021","4571/201","1","21","0 Months","15","0"
"6433da348a12e9ad0dd6b985","643373178a12e9ad0d2fa453","10/01/2022","4571/201","1","20","0 Months","10","0"
"6433da348a12e9ad0dd6b986","643373178a12e9ad0d2fa453","13/01/2022","4571/201","2","18","0 Months","20","0"
"6433da348a12e9ad0dd6b987","643373178a12e9ad0d2fa453","15/01/2022","4571/201","10","8","0 Months","150","0"
"6433da348a12e9ad0dd6b988","643373178a12e9ad0d2fa453","27/01/2022","4571/201","8","0","0 Months","90","0"
"6433da348a12e9ad0dd6b989","643373178a12e9ad0d2fa454","31/03/2020","4892/739","34","705","0 Months","0","0"
"6433da348a12e9ad0dd6b98a","643373178a12e9ad0d2fa454","05/10/2020","4892/739","40","665","0 Months","146","0"
"6433da348a12e9ad0dd6b98b","643373178a12e9ad0d2fa454","11/10/2020","4892/739","40","625","0 Months","147","0"
"6433da348a12e9ad0dd6b98c","643373178a12e9ad0d2fa454","16/10/2020","4892/739","60","565","0 Months","220","0"
"6433da348a12e9ad0dd6b98d","643373178a12e9ad0d2fa454","19/10/2020","4892/739","30","535","0 Months","110","0"
"6433da348a12e9ad0dd6b98e","643373178a12e9ad0d2fa454","23/10/2020","4892/739","50","485","0 Months","183","0"
"6433da348a12e9ad0dd6b98f","643373178a12e9ad0d2fa454","25/10/2020","4892/739","30","455","0 Months","110","0"
"6433da348a12e9ad0dd6b990","643373178a12e9ad0d2fa454","31/10/2020","4892/739","20","435","0 Months","73","0"
"6433da348a12e9ad0dd6b991","643373178a12e9ad0d2fa454","01/11/2020","4892/739","60","375","0 Months","220","0"
"6433da348a12e9ad0dd6b992","643373178a12e9ad0d2fa454","13/11/2020","4892/739","20","355","0 Months","73","0"
"6433da348a12e9ad0dd6b993","643373178a12e9ad0d2fa454","15/11/2020","4892/739","30","325","0 Months","110","0"
"6433da348a12e9ad0dd6b994","643373178a12e9ad0d2fa454","22/11/2020","4892/739","20","305","0 Months","73","0"
"6433da348a12e9ad0dd6b995","643373178a12e9ad0d2fa454","28/11/2020","4892/739","20","285","0 Months","73","0"
"6433da348a12e9ad0dd6b996","643373178a12e9ad0d2fa454","02/12/2020","4892/739","45","240","0 Months","169","0"
"6433da348a12e9ad0dd6b997","643373178a12e9ad0d2fa454","10/12/2020","4892/739","60","180","0 Months","219","0"
"6433da348a12e9ad0dd6b998","643373178a12e9ad0d2fa454","13/12/2020","4892/739","40","140","0 Months","146","0"
"6433da348a12e9ad0dd6b999","643373178a12e9ad0d2fa454","16/12/2020","4892/739","30","110","0 Months","109","0"
"6433da348a12e9ad0dd6b99a","643373178a12e9ad0d2fa454","21/12/2020","4892/739","20","90","0 Months","73","0"
"6433da348a12e9ad0dd6b99b","643373178a12e9ad0d2fa454","24/12/2020","4892/739","20","70","0 Months","73","0"
"6433da348a12e9ad0dd6b99c","643373178a12e9ad0d2fa454","27/12/2020","4892/739","50","20","0 Months","183","0"
"6433da348a12e9ad0dd6b99d","643373178a12e9ad0d2fa454","17/01/2021","4892/739","20","0","0 Months","73","0"
"6433da348a12e9ad0dd6b99e","643373178a12e9ad0d2fa455","15/05/2021","6503/44","2","42","0 Months","28","0"
"6433da348a12e9ad0dd6b99f","643373178a12e9ad0d2fa455","17/05/2021","6503/44","2","40","0 Months","28","0"
"6433da348a12e9ad0dd6b9a0","643373178a12e9ad0d2fa455","28/05/2021","6503/44","1","39","0 Months","14","0"
"6433da348a12e9ad0dd6b9a1","643373178a12e9ad0d2fa455","18/06/2021","6503/44","2","37","0 Months","30","0"
"6433da348a12e9ad0dd6b9a2","643373178a12e9ad0d2fa455","30/06/2021","6503/44","2","35","0 Months","30","0"
"6433da348a12e9ad0dd6b9a3","643373178a12e9ad0d2fa455","07/07/2021","6503/44","2","33","0 Months","30","0"
"6433da348a12e9ad0dd6b9a4","643373178a12e9ad0d2fa455","09/08/2021","6503/44","1","32","0 Months","25","0"
"6433da348a12e9ad0dd6b9a5","643373178a12e9ad0d2fa455","26/08/2021","6503/44","1","31","0 Months","15","0"
"6433da348a12e9ad0dd6b9a6","643373178a12e9ad0d2fa455","20/09/2021","6503/44","2","29","0 Months","30","0"
"6433da348a12e9ad0dd6b9a7","643373178a12e9ad0d2fa455","26/09/2021","6503/44","2","27","0 Months","30","0"
"6433da348a12e9ad0dd6b9a8","643373178a12e9ad0d2fa455","11/10/2021","6503/44","2","25","0 Months","25","0"
"6433da348a12e9ad0dd6b9a9","643373178a12e9ad0d2fa455","29/11/2021","6503/44","2","23","0 Months","30","0"
"6433da348a12e9ad0dd6b9aa","643373178a12e9ad0d2fa455","27/12/2021","6503/44","2","21","0 Months","30","0"
"6433da348a12e9ad0dd6b9ab","643373178a12e9ad0d2fa455","06/01/2022","6503/44","2","19","0 Months","30","0"
"6433da348a12e9ad0dd6b9ac","643373178a12e9ad0d2fa455","10/01/2022","6503/44","2","17","0 Months","30","0"
"6433da348a12e9ad0dd6b9ad","643373178a12e9ad0d2fa455","24/01/2022","6503/44","4","13","0 Months","60","0"
"6433da348a12e9ad0dd6b9ae","643373178a12e9ad0d2fa455","06/02/2022","6503/44","5","8","0 Months","70","0"
"6433da348a12e9ad0dd6b9af","643373178a12e9ad0d2fa455","14/02/2022","6503/44","2","6","0 Months","30","0"
"6433da348a12e9ad0dd6b9b0","643373178a12e9ad0d2fa455","28/02/2022","6503/44","4","2","0 Months","55","0"
"6433da348a12e9ad0dd6b9b1","643373178a12e9ad0d2fa455","25/03/2022","6503/44","2","0","0 Months","28","0"
"6433da348a12e9ad0dd6b9b2","643373178a12e9ad0d2fa456","23/04/2021","6720/409","3","406","0 Months","34","0"
"6433da348a12e9ad0dd6b9b3","643373178a12e9ad0d2fa456","25/04/2021","6720/409","5","401","0 Months","56","0"
"6433da348a12e9ad0dd6b9b4","643373178a12e9ad0d2fa456","26/04/2021","6720/409","5","396","0 Months","56","0"
"6433da348a12e9ad0dd6b9b5","643373178a12e9ad0d2fa456","29/04/2021","6720/409","4","392","0 Months","46","0"
"6433da348a12e9ad0dd6b9b6","643373178a12e9ad0d2fa456","07/05/2021","6720/409","7","385","0 Months","80","0"
"6433da348a12e9ad0dd6b9b7","643373178a12e9ad0d2fa456","09/05/2021","6720/409","10","375","0 Months","114","0"
"6433da348a12e9ad0dd6b9b8","643373178a12e9ad0d2fa456","15/05/2021","6720/409","10","365","0 Months","114","0"
"6433da348a12e9ad0dd6b9b9","643373178a12e9ad0d2fa456","29/05/2021","6720/409","3","362","0 Months","34","0"
"6433da348a12e9ad0dd6b9ba","643373178a12e9ad0d2fa456","03/06/2021","6720/409","3","359","0 Months","33","0"
"6433da348a12e9ad0dd6b9bb","643373178a12e9ad0d2fa456","05/06/2021","6720/409","5","354","0 Months","56","0"
"6433da348a12e9ad0dd6b9bc","643373178a12e9ad0d2fa456","09/06/2021","6720/409","5","349","0 Months","55","0"
"6433da348a12e9ad0dd6b9bd","643373178a12e9ad0d2fa456","16/06/2021","6720/409","5","344","0 Months","60","0"
"6433da348a12e9ad0dd6b9be","643373178a12e9ad0d2fa456","23/06/2021","6720/409","3","341","0 Months","35","0"
"6433da348a12e9ad0dd6b9bf","643373178a12e9ad0d2fa456","26/06/2021","6720/409","8","333","0 Months","90","0"
"6433da348a12e9ad0dd6b9c0","643373178a12e9ad0d2fa456","30/06/2021","6720/409","4","329","0 Months","45","0"
"6433da348a12e9ad0dd6b9c1","643373178a12e9ad0d2fa456","11/07/2021","6720/409","8","321","0 Months","90","0"
"6433da348a12e9ad0dd6b9c2","643373178a12e9ad0d2fa456","15/07/2021","6720/409","5","316","0 Months","55","0"
"6433da348a12e9ad0dd6b9c3","643373178a12e9ad0d2fa456","21/07/2021","6720/409","5","311","0 Months","55","0"
"6433da348a12e9ad0dd6b9c4","643373178a12e9ad0d2fa456","25/07/2021","6720/409","3","308","0 Months","35","0"
"6433da348a12e9ad0dd6b9c5","643373178a12e9ad0d2fa456","05/08/2021","6720/409","2","306","0 Months","20","0"
"6433da348a12e9ad0dd6b9c6","643373178a12e9ad0d2fa456","08/08/2021","6720/409","3","303","0 Months","35","0"
"6433da348a12e9ad0dd6b9c7","643373178a12e9ad0d2fa456","11/08/2021","6720/409","3","300","0 Months","35","0"
"6433da348a12e9ad0dd6b9c8","643373178a12e9ad0d2fa456","13/08/2021","6720/409","5","295","0 Months","55","0"
"6433da348a12e9ad0dd6b9c9","643373178a12e9ad0d2fa456","16/08/2021","6720/409","5","290","0 Months","55","0"
"6433da348a12e9ad0dd6b9ca","643373178a12e9ad0d2fa456","19/08/2021","6720/409","5","285","0 Months","55","0"
"6433da348a12e9ad0dd6b9cb","643373178a12e9ad0d2fa456","25/08/2021","6720/409","5","280","0 Months","55","0"
"6433da348a12e9ad0dd6b9cc","643373178a12e9ad0d2fa456","26/08/2021","6720/409","3","277","0 Months","35","0"
"6433da348a12e9ad0dd6b9cd","643373178a12e9ad0d2fa456","02/09/2021","6720/409","3","274","0 Months","35","0"
"6433da348a12e9ad0dd6b9ce","643373178a12e9ad0d2fa456","03/09/2021","6720/409","3","271","0 Months","30","0"
"6433da348a12e9ad0dd6b9cf","643373178a12e9ad0d2fa456","04/09/2021","6720/409","5","266","0 Months","55","0"
"6433da348a12e9ad0dd6b9d0","643373178a12e9ad0d2fa456","08/09/2021","6720/409","5","261","0 Months","55","0"
"6433da348a12e9ad0dd6b9d1","643373178a12e9ad0d2fa456","11/09/2021","6720/409","6","255","0 Months","70","0"
"6433da348a12e9ad0dd6b9d2","643373178a12e9ad0d2fa456","15/09/2021","6720/409","6","249","0 Months","70","0"
"6433da348a12e9ad0dd6b9d3","643373178a12e9ad0d2fa456","17/09/2021","6720/409","3","246","0 Months","35","0"
"6433da348a12e9ad0dd6b9d4","643373178a12e9ad0d2fa456","19/09/2021","6720/409","3","243","0 Months","35","0"
"6433da348a12e9ad0dd6b9d5","643373178a12e9ad0d2fa456","22/09/2021","6720/409","5","238","0 Months","55","0"
"6433da348a12e9ad0dd6b9d6","643373178a12e9ad0d2fa456","24/09/2021","6720/409","3","235","0 Months","35","0"
"6433da348a12e9ad0dd6b9d7","643373178a12e9ad0d2fa456","25/09/2021","6720/409","3","232","0 Months","35","0"
"6433da348a12e9ad0dd6b9d8","643373178a12e9ad0d2fa456","03/10/2021","6720/409","5","227","0 Months","55","0"
"6433da348a12e9ad0dd6b9d9","643373178a12e9ad0d2fa456","06/10/2021","6720/409","5","222","0 Months","55","0"
"6433da348a12e9ad0dd6b9da","643373178a12e9ad0d2fa456","06/10/2021","6720/409","4","218","0 Months","45","0"
"6433da348a12e9ad0dd6b9db","643373178a12e9ad0d2fa456","10/10/2021","6720/409","6","212","0 Months","65","0"
"6433da348a12e9ad0dd6b9dc","643373178a12e9ad0d2fa456","13/10/2021","6720/409","5","207","0 Months","55","0"
"6433da348a12e9ad0dd6b9dd","643373178a12e9ad0d2fa456","18/10/2021","6720/409","3","204","0 Months","40","0"
"6433da348a12e9ad0dd6b9de","643373178a12e9ad0d2fa456","20/10/2021","6720/409","4","200","0 Months","45","0"
"6433da348a12e9ad0dd6b9df","643373178a12e9ad0d2fa456","23/10/2021","6720/409","8","192","0 Months","90","0"
"6433da348a12e9ad0dd6b9e0","643373178a12e9ad0d2fa456","27/10/2021","6720/409","5","187","0 Months","55","0"
"6433da348a12e9ad0dd6b9e1","643373178a12e9ad0d2fa456","29/10/2021","6720/409","4","183","0 Months","45","0"
"6433da348a12e9ad0dd6b9e2","643373178a12e9ad0d2fa456","25/11/2021","6720/409","6","177","0 Months","70","0"
"6433da348a12e9ad0dd6b9e3","643373178a12e9ad0d2fa456","23/01/2022","6720/409","10","167","0 Months","110","0"
"6433da348a12e9ad0dd6b9e4","643373178a12e9ad0d2fa456","28/01/2022","6720/409","10","157","0 Months","115","0"
"6433da348a12e9ad0dd6b9e5","643373178a12e9ad0d2fa456","30/01/2022","6720/409","5","152","0 Months","55","0"
"6433da348a12e9ad0dd6b9e6","643373178a12e9ad0d2fa456","02/02/2022","6720/409","6","146","0 Months","70","0"
"6433da348a12e9ad0dd6b9e7","643373178a12e9ad0d2fa456","05/02/2022","6720/409","6","140","0 Months","70","0"
"6433da348a12e9ad0dd6b9e8","643373178a12e9ad0d2fa456","10/02/2022","6720/409","6","134","0 Months","70","0"
"6433da348a12e9ad0dd6b9e9","643373178a12e9ad0d2fa456","13/02/2022","6720/409","12","122","0 Months","135","0"
"6433da348a12e9ad0dd6b9ea","643373178a12e9ad0d2fa456","19/02/2022","6720/409","12","110","0 Months","130","0"
"6433da348a12e9ad0dd6b9eb","643373178a12e9ad0d2fa456","26/02/2022","6720/409","10","100","0 Months","110","0"
"6433da348a12e9ad0dd6b9ec","643373178a12e9ad0d2fa456","05/03/2022","6720/409","10","90","0 Months","114","0"
"6433da348a12e9ad0dd6b9ed","643373178a12e9ad0d2fa456","10/03/2022","6720/409","5","85","0 Months","55","0"
"6433da348a12e9ad0dd6b9ee","643373178a12e9ad0d2fa456","12/03/2022","6720/409","5","80","0 Months","57","0"
"6433da348a12e9ad0dd6b9ef","643373178a12e9ad0d2fa456","18/03/2022","6720/409","4","76","0 Months","47","0"
"6433da348a12e9ad0dd6b9f0","643373178a12e9ad0d2fa456","19/03/2022","6720/409","4","72","0 Months","46","0"
"6433da348a12e9ad0dd6b9f1","643373178a12e9ad0d2fa456","21/03/2022","6720/409","4","68","0 Months","46","0"
"6433da348a12e9ad0dd6b9f2","643373178a12e9ad0d2fa456","23/03/2022","6720/409","10","58","0 Months","115","0"
"6433da348a12e9ad0dd6b9f3","643373178a12e9ad0d2fa456","26/03/2022","6720/409","10","48","0 Months","115","0"
"6433da348a12e9ad0dd6b9f4","643373178a12e9ad0d2fa456","31/03/2022","6720/409","10","38","0 Months","115","0"
"6433da348a12e9ad0dd6b9f5","643373178a12e9ad0d2fa456","03/04/2022","6720/409","10","28","0 Months","115","0"
"6433da348a12e9ad0dd6b9f6","643373178a12e9ad0d2fa456","07/04/2022","6720/409","10","18","0 Months","115","0"
"6433da348a12e9ad0dd6b9f7","643373178a12e9ad0d2fa456","11/04/2022","6720/409","10","8","0 Months","115","0"
"6433da348a12e9ad0dd6b9f8","643373178a12e9ad0d2fa456","16/04/2022","6720/409","6","2","0 Months","70","0"
"6433da348a12e9ad0dd6b9f9","643373178a12e9ad0d2fa456","16/04/2022","6720/409","2","0","0 Months","22","0"
"6433da348a12e9ad0dd6b9fa","643373178a12e9ad0d2fa457","30/04/2021","6749/200","2","198","0 Months","28","0"
"6433da348a12e9ad0dd6b9fb","643373178a12e9ad0d2fa457","05/05/2021","6749/200","5","193","0 Months","72","0"
"6433da348a12e9ad0dd6b9fc","643373178a12e9ad0d2fa457","09/05/2021","6749/200","29","164","0 Months","417","0"
"6433da348a12e9ad0dd6b9fd","643373178a12e9ad0d2fa457","28/05/2021","6749/200","2","162","0 Months","28","0"
"6433da348a12e9ad0dd6b9fe","643373178a12e9ad0d2fa457","26/06/2021","6749/200","1","161","0 Months","15","0"
"6433da348a12e9ad0dd6b9ff","643373178a12e9ad0d2fa457","30/06/2021","6749/200","1","160","0 Months","15","0"
"6433da348a12e9ad0dd6ba00","643373178a12e9ad0d2fa457","19/07/2021","6749/200","2","158","0 Months","30","0"
"6433da348a12e9ad0dd6ba01","643373178a12e9ad0d2fa457","23/07/2021","6749/200","2","156","0 Months","30","0"
"6433da348a12e9ad0dd6ba02","643373178a12e9ad0d2fa457","29/07/2021","6749/200","2","154","0 Months","30","0"
"6433da348a12e9ad0dd6ba03","643373178a12e9ad0d2fa457","30/07/2021","6749/200","2","152","0 Months","30","0"
"6433da348a12e9ad0dd6ba04","643373178a12e9ad0d2fa457","31/07/2021","6749/200","1","151","0 Months","15","0"
"6433da348a12e9ad0dd6ba05","643373178a12e9ad0d2fa457","08/08/2021","6749/200","3","148","0 Months","45","0"
"6433da348a12e9ad0dd6ba06","643373178a12e9ad0d2fa457","18/08/2021","6749/200","2","146","0 Months","25","0"
"6433da348a12e9ad0dd6ba07","643373178a12e9ad0d2fa457","28/08/2021","6749/200","1","145","0 Months","15","0"
"6433da348a12e9ad0dd6ba09","643373178a12e9ad0d2fa457","01/09/2021","6749/200","5","140","0 Months","70","0"
"6433da348a12e9ad0dd6ba0a","643373178a12e9ad0d2fa457","04/09/2021","6749/200","1","139","0 Months","10","0"
"6433da348a12e9ad0dd6ba0b","643373178a12e9ad0d2fa457","23/09/2021","6749/200","2","137","0 Months","30","0"
"6433da348a12e9ad0dd6ba0c","643373178a12e9ad0d2fa457","24/09/2021","6749/200","2","135","0 Months","30","0"
"6433da348a12e9ad0dd6ba0d","643373178a12e9ad0d2fa457","29/09/2021","6749/200","5","130","0 Months","70","0"
"6433da348a12e9ad0dd6ba0e","643373178a12e9ad0d2fa457","30/09/2021","6749/200","1","129","0 Months","15","0"
"6433da348a12e9ad0dd6ba0f","643373178a12e9ad0d2fa457","30/09/2021","6749/200","2","127","0 Months","30","0"
"6433da348a12e9ad0dd6ba10","643373178a12e9ad0d2fa457","01/10/2021","6749/200","1","126","0 Months","15","0"
"6433da348a12e9ad0dd6ba11","643373178a12e9ad0d2fa457","04/10/2021","6749/200","1","125","0 Months","15","0"
"6433da348a12e9ad0dd6ba12","643373178a12e9ad0d2fa457","08/10/2021","6749/200","2","123","0 Months","30","0"
"6433da348a12e9ad0dd6ba13","643373178a12e9ad0d2fa457","11/10/2021","6749/200","2","121","0 Months","25","0"
"6433da348a12e9ad0dd6ba14","643373178a12e9ad0d2fa457","24/10/2021","6749/200","10","111","0 Months","145","0"
"6433da348a12e9ad0dd6ba15","643373178a12e9ad0d2fa457","28/10/2021","6749/200","1","110","0 Months","15","0"
"6433da348a12e9ad0dd6ba16","643373178a12e9ad0d2fa457","29/10/2021","6749/200","5","105","0 Months","30","0"
"6433da348a12e9ad0dd6ba17","643373178a12e9ad0d2fa457","30/10/2021","6749/200","1","104","0 Months","15","0"
"6433da348a12e9ad0dd6ba18","643373178a12e9ad0d2fa457","05/11/2021","6749/200","1","103","0 Months","15","0"
"6433da348a12e9ad0dd6ba19","643373178a12e9ad0d2fa457","05/11/2021","6749/200","5","98","0 Months","70","0"
"6433da348a12e9ad0dd6ba1a","643373178a12e9ad0d2fa457","07/11/2021","6749/200","1","97","0 Months","15","0"
"6433da348a12e9ad0dd6ba1b","643373178a12e9ad0d2fa457","21/11/2021","6749/200","1","96","0 Months","15","0"
"6433da348a12e9ad0dd6ba1c","643373178a12e9ad0d2fa457","25/11/2021","6749/200","4","92","0 Months","55","0"
"6433da348a12e9ad0dd6ba1d","643373178a12e9ad0d2fa457","26/11/2021","6749/200","2","90","0 Months","25","0"
"6433da348a12e9ad0dd6ba1e","643373178a12e9ad0d2fa457","28/11/2021","6749/200","3","87","0 Months","45","0"
"6433da348a12e9ad0dd6ba1f","643373178a12e9ad0d2fa457","29/11/2021","6749/200","1","86","0 Months","15","0"
"6433da348a12e9ad0dd6ba20","643373178a12e9ad0d2fa457","08/12/2021","6749/200","2","84","0 Months","30","0"
"6433da348a12e9ad0dd6ba21","643373178a12e9ad0d2fa457","16/12/2021","6749/200","5","79","0 Months","70","0"
"6433da348a12e9ad0dd6ba22","643373178a12e9ad0d2fa457","20/12/2021","6749/200","4","75","0 Months","55","0"
"6433da348a12e9ad0dd6ba23","643373178a12e9ad0d2fa457","22/12/2021","6749/200","1","74","0 Months","15","0"
"6433da348a12e9ad0dd6ba24","643373178a12e9ad0d2fa457","25/12/2021","6749/200","1","73","0 Months","15","0"
"6433da348a12e9ad0dd6ba25","643373178a12e9ad0d2fa457","26/12/2021","6749/200","1","72","0 Months","15","0"
"6433da348a12e9ad0dd6ba26","643373178a12e9ad0d2fa457","30/12/2021","6749/200","3","69","0 Months","45","0"
"6433da348a12e9ad0dd6ba27","643373178a12e9ad0d2fa457","10/01/2022","6749/200","2","67","0 Months","50","0"
"6433da348a12e9ad0dd6ba28","643373178a12e9ad0d2fa457","13/01/2022","6749/200","2","65","0 Months","30","0"
"6433da348a12e9ad0dd6ba29","643373178a12e9ad0d2fa457","22/01/2022","6749/200","1","64","0 Months","15","0"
"6433da348a12e9ad0dd6ba2a","643373178a12e9ad0d2fa457","23/01/2022","6749/200","1","63","0 Months","15","0"
"6433da348a12e9ad0dd6ba2b","643373178a12e9ad0d2fa457","23/04/2022","6749/200","2","61","0 Months","28","0"
"6433da348a12e9ad0dd6ba2c","643373178a12e9ad0d2fa457","14/05/2022","6749/200","2","59","0 Months","28","0"
"6433da348a12e9ad0dd6ba2d","643373178a12e9ad0d2fa457","18/05/2022","6749/200","1","58","0 Months","14","0"
"6433da348a12e9ad0dd6ba2e","643373178a12e9ad0d2fa457","19/05/2022","6749/200","2","56","0 Months","28","0"
"6433da348a12e9ad0dd6ba2f","643373178a12e9ad0d2fa457","28/05/2022","6749/200","3","53","0 Months","43","0"
"6433da348a12e9ad0dd6ba30","643373178a12e9ad0d2fa457","02/06/2022","6749/200","4","49","0 Months","57","0"
"6433da348a12e9ad0dd6ba31","643373178a12e9ad0d2fa457","05/06/2022","6749/200","7","42","0 Months","100","0"
"6433da348a12e9ad0dd6ba32","643373178a12e9ad0d2fa457","10/06/2022","6749/200","2","40","0 Months","28","0"
"6433da348a12e9ad0dd6ba33","643373178a12e9ad0d2fa457","18/06/2022","6749/200","2","38","0 Months","28","0"
"6433da348a12e9ad0dd6ba34","643373178a12e9ad0d2fa457","19/06/2022","6749/200","5","33","0 Months","72","0"
"6433da348a12e9ad0dd6ba35","643373178a12e9ad0d2fa457","23/06/2022","6749/200","1","32","0 Months","14","0"
"6433da348a12e9ad0dd6ba36","643373178a12e9ad0d2fa457","30/07/2022","6749/200","1","31","0 Months","14","0"
"6433da348a12e9ad0dd6ba37","643373178a12e9ad0d2fa457","27/08/2022","6749/200","2","29","0 Months","35","0"
"6433da348a12e9ad0dd6ba38","643373178a12e9ad0d2fa457","05/09/2022","6749/200","2","27","0 Months","57","0"
"6433da348a12e9ad0dd6ba39","643373178a12e9ad0d2fa457","12/09/2022","6749/200","4","23","0 Months","70","0"
"6433da348a12e9ad0dd6ba3a","643373178a12e9ad0d2fa457","16/09/2022","6749/200","2","21","0 Months","35","0"
"6433da348a12e9ad0dd6ba3b","643373178a12e9ad0d2fa457","23/09/2022","6749/200","1","20","0 Months","17","0"
"6433da348a12e9ad0dd6ba3c","643373178a12e9ad0d2fa457","24/09/2022","6749/200","8","12","0 Months","140","0"
"6433da348a12e9ad0dd6ba3d","643373178a12e9ad0d2fa457","03/12/2022","6749/200","1","11","0 Months","17","0"
"6433da348a12e9ad0dd6ba3e","643373178a12e9ad0d2fa457","04/12/2022","6749/200","4","7","0 Months","70","0"
"6433da348a12e9ad0dd6ba3f","643373178a12e9ad0d2fa457","22/12/2022","6749/200","7","0","0 Months","0","0"
"6433da348a12e9ad0dd6ba40","643373178a12e9ad0d2fa458","05/11/2021","7044/24","24","0","0 Months","50","0"
"6433da348a12e9ad0dd6ba41","643373178a12e9ad0d2fa459","27/04/2022","7294/202","5","197","0 Months","72","0"
"6433da348a12e9ad0dd6ba42","643373178a12e9ad0d2fa459","04/05/2022","7294/202","5","192","0 Months","72","0"
"6433da348a12e9ad0dd6ba43","643373178a12e9ad0d2fa459","13/05/2022","7294/202","11","181","0 Months","158","0"
"6433da348a12e9ad0dd6ba44","643373178a12e9ad0d2fa459","18/05/2022","7294/202","3","178","0 Months","43","0"
"6433da348a12e9ad0dd6ba45","643373178a12e9ad0d2fa459","21/05/2022","7294/202","2","176","0 Months","28","0"
"6433da348a12e9ad0dd6ba46","643373178a12e9ad0d2fa459","27/05/2022","7294/202","2","174","0 Months","28","0"
"6433da348a12e9ad0dd6ba47","643373178a12e9ad0d2fa459","01/06/2022","7294/202","2","172","0 Months","28","0"
"6433da348a12e9ad0dd6ba48","643373178a12e9ad0d2fa459","01/06/2022","7294/202","2","170","0 Months","28","0"
"6433da348a12e9ad0dd6ba49","643373178a12e9ad0d2fa459","18/06/2022","7294/202","2","168","0 Months","28","0"
"6433da348a12e9ad0dd6ba4a","643373178a12e9ad0d2fa459","19/06/2022","7294/202","1","167","0 Months","14","0"
"6433da348a12e9ad0dd6ba4b","643373178a12e9ad0d2fa459","02/07/2022","7294/202","2","165","0 Months","28","0"
"6433da348a12e9ad0dd6ba4c","643373178a12e9ad0d2fa459","23/07/2022","7294/202","3","162","0 Months","43","0"
"6433da348a12e9ad0dd6ba4d","643373178a12e9ad0d2fa459","05/08/2022","7294/202","2","160","0 Months","28","0"
"6433da348a12e9ad0dd6ba4e","643373178a12e9ad0d2fa459","06/08/2022","7294/202","2","158","0 Months","28","0"
"6433da348a12e9ad0dd6ba4f","643373178a12e9ad0d2fa459","07/08/2022","7294/202","2","156","0 Months","28","0"
"6433da348a12e9ad0dd6ba50","643373178a12e9ad0d2fa459","14/08/2022","7294/202","1","155","0 Months","17","0"
"6433da348a12e9ad0dd6ba51","643373178a12e9ad0d2fa459","24/08/2022","7294/202","1","154","0 Months","17","0"
"6433da348a12e9ad0dd6ba52","643373178a12e9ad0d2fa459","26/08/2022","7294/202","1","153","0 Months","17","0"
"6433da348a12e9ad0dd6ba53","643373178a12e9ad0d2fa459","28/08/2022","7294/202","2","151","0 Months","35","0"
"6433da348a12e9ad0dd6ba54","643373178a12e9ad0d2fa459","01/09/2022","7294/202","2","149","0 Months","35","0"
"6433da348a12e9ad0dd6ba55","643373178a12e9ad0d2fa459","01/09/2022","7294/202","1","148","0 Months","17","0"
"6433da348a12e9ad0dd6ba56","643373178a12e9ad0d2fa459","02/09/2022","7294/202","5","143","0 Months","88","0"
"6433da348a12e9ad0dd6ba57","643373178a12e9ad0d2fa459","02/09/2022","7294/202","1","142","0 Months","17","0"
"6433da348a12e9ad0dd6ba58","643373178a12e9ad0d2fa459","02/09/2022","7294/202","3","139","0 Months","52","0"
"6433da348a12e9ad0dd6ba59","643373178a12e9ad0d2fa459","04/09/2022","7294/202","2","137","0 Months","35","0"
"6433da348a12e9ad0dd6ba5a","643373178a12e9ad0d2fa459","07/09/2022","7294/202","5","132","0 Months","88","0"
"6433da348a12e9ad0dd6ba5b","643373178a12e9ad0d2fa459","11/09/2022","7294/202","3","129","0 Months","53","0"
"6433da348a12e9ad0dd6ba5c","643373178a12e9ad0d2fa459","11/09/2022","7294/202","2","127","0 Months","35","0"
"6433da348a12e9ad0dd6ba5d","643373178a12e9ad0d2fa459","15/09/2022","7294/202","9","118","0 Months","158","0"
"6433da348a12e9ad0dd6ba5e","643373178a12e9ad0d2fa459","16/09/2022","7294/202","4","114","0 Months","70","0"
"6433da348a12e9ad0dd6ba5f","643373178a12e9ad0d2fa459","16/09/2022","7294/202","7","107","0 Months","123","0"
"6433da348a12e9ad0dd6ba60","643373178a12e9ad0d2fa459","18/09/2022","7294/202","7","100","0 Months","123","0"
"6433da348a12e9ad0dd6ba61","643373178a12e9ad0d2fa459","18/09/2022","7294/202","2","98","0 Months","35","0"
"6433da348a12e9ad0dd6ba62","643373178a12e9ad0d2fa459","18/09/2022","7294/202","1","97","0 Months","17","0"
"6433da348a12e9ad0dd6ba63","643373178a12e9ad0d2fa459","19/09/2022","7294/202","10","87","0 Months","170","0"
"6433da348a12e9ad0dd6ba64","643373178a12e9ad0d2fa459","21/09/2022","7294/202","3","84","0 Months","52","0"
"6433da348a12e9ad0dd6ba65","643373178a12e9ad0d2fa459","21/09/2022","7294/202","4","80","0 Months","70","0"
"6433da348a12e9ad0dd6ba66","643373178a12e9ad0d2fa459","23/09/2022","7294/202","1","79","0 Months","17","0"
"6433da348a12e9ad0dd6ba67","643373178a12e9ad0d2fa459","24/09/2022","7294/202","4","75","0 Months","70","0"
"6433da348a12e9ad0dd6ba68","643373178a12e9ad0d2fa459","25/09/2022","7294/202","1","74","0 Months","17","0"
"6433da348a12e9ad0dd6ba69","643373178a12e9ad0d2fa459","25/09/2022","7294/202","9","65","0 Months","158","0"
"6433da348a12e9ad0dd6ba6a","643373178a12e9ad0d2fa459","28/09/2022","7294/202","3","62","0 Months","52","0"
"6433da348a12e9ad0dd6ba6b","643373178a12e9ad0d2fa459","30/09/2022","7294/202","6","56","0 Months","106","0"
"6433da348a12e9ad0dd6ba6c","643373178a12e9ad0d2fa459","01/10/2022","7294/202","1","55","0 Months","17","0"
"6433da348a12e9ad0dd6ba6d","643373178a12e9ad0d2fa459","01/10/2022","7294/202","2","53","0 Months","35","0"
"6433da348a12e9ad0dd6ba6e","643373178a12e9ad0d2fa459","05/10/2022","7294/202","1","52","0 Months","17","0"
"6433da348a12e9ad0dd6ba6f","643373178a12e9ad0d2fa459","08/10/2022","7294/202","2","50","0 Months","35","0"
"6433da348a12e9ad0dd6ba70","643373178a12e9ad0d2fa459","09/10/2022","7294/202","6","44","0 Months","105","0"
"6433da348a12e9ad0dd6ba71","643373178a12e9ad0d2fa459","10/10/2022","7294/202","1","43","0 Months","17","0"
"6433da348a12e9ad0dd6ba72","643373178a12e9ad0d2fa459","20/10/2022","7294/202","3","40","0 Months","52","0"
"6433da348a12e9ad0dd6ba73","643373178a12e9ad0d2fa459","21/10/2022","7294/202","3","37","0 Months","52","0"
"6433da348a12e9ad0dd6ba74","643373178a12e9ad0d2fa459","21/10/2022","7294/202","1","36","0 Months","17","0"
"6433da348a12e9ad0dd6ba75","643373178a12e9ad0d2fa459","22/10/2022","7294/202","3","33","0 Months","52","0"
"6433da348a12e9ad0dd6ba76","643373178a12e9ad0d2fa459","28/10/2022","7294/202","4","29","0 Months","70","0"
"6433da348a12e9ad0dd6ba77","643373178a12e9ad0d2fa459","30/10/2022","7294/202","1","28","0 Months","17","0"
"6433da348a12e9ad0dd6ba78","643373178a12e9ad0d2fa459","02/11/2022","7294/202","3","25","0 Months","52","0"
"6433da348a12e9ad0dd6ba79","643373178a12e9ad0d2fa459","02/11/2022","7294/202","1","24","0 Months","17","0"
"6433da348a12e9ad0dd6ba7a","643373178a12e9ad0d2fa459","03/11/2022","7294/202","2","22","0 Months","35","0"
"6433da348a12e9ad0dd6ba7b","643373178a12e9ad0d2fa459","04/11/2022","7294/202","3","19","0 Months","52","0"
"6433da348a12e9ad0dd6ba7c","643373178a12e9ad0d2fa459","06/11/2022","7294/202","1","18","0 Months","17","0"
"6433da348a12e9ad0dd6ba7d","643373178a12e9ad0d2fa459","10/11/2022","7294/202","2","16","0 Months","35","0"
"6433da348a12e9ad0dd6ba7e","643373178a12e9ad0d2fa459","10/11/2022","7294/202","1","15","0 Months","17","0"
"6433da348a12e9ad0dd6ba7f","643373178a12e9ad0d2fa459","13/11/2022","7294/202","1","14","0 Months","17","0"
"6433da348a12e9ad0dd6ba80","643373178a12e9ad0d2fa459","13/11/2022","7294/202","2","12","0 Months","35","0"
"6433da348a12e9ad0dd6ba81","643373178a12e9ad0d2fa459","17/11/2022","7294/202","2","10","0 Months","35","0"
"6433da348a12e9ad0dd6ba82","643373178a12e9ad0d2fa459","18/11/2022","7294/202","2","8","0 Months","35","0"
"6433da348a12e9ad0dd6ba83","643373178a12e9ad0d2fa459","24/11/2022","7294/202","3","5","0 Months","52","0"
"6433da348a12e9ad0dd6ba84","643373178a12e9ad0d2fa459","30/11/2022","7294/202","1","4","0 Months","17","0"
"6433da348a12e9ad0dd6ba85","643373178a12e9ad0d2fa459","01/12/2022","7294/202","1","3","0 Months","17","0"
"6433da348a12e9ad0dd6ba86","643373178a12e9ad0d2fa459","08/12/2022","7294/202","1","2","0 Months","17","0"
"6433da348a12e9ad0dd6ba87","643373178a12e9ad0d2fa459","12/12/2022","7294/202","1","1","0 Months","17","0"
"6433da348a12e9ad0dd6ba88","643373178a12e9ad0d2fa459","14/12/2022","7294/202","1","0","0 Months","17","0"
"6433da348a12e9ad0dd6ba89","643373178a12e9ad0d2fa45a","14/08/2022","8162/201","25","176","0 Months","279","0"
"6433da348a12e9ad0dd6ba8a","643373178a12e9ad0d2fa45a","20/08/2022","8162/201","25","151","0 Months","277","0"
"6433da348a12e9ad0dd6ba8b","643373178a12e9ad0d2fa45a","26/08/2022","8162/201","25","126","0 Months","279","0"
"6433da348a12e9ad0dd6ba8c","643373178a12e9ad0d2fa45a","03/09/2022","8162/201","25","101","0 Months","279","0"
"6433da348a12e9ad0dd6ba8d","643373178a12e9ad0d2fa45a","15/09/2022","8162/201","25","76","0 Months","279","0"
"6433da348a12e9ad0dd6ba8e","643373178a12e9ad0d2fa45a","28/09/2022","8162/201","25","51","0 Months","279","0"
"6433da348a12e9ad0dd6ba8f","643373178a12e9ad0d2fa45a","12/10/2022","8162/201","25","26","0 Months","278","0"
"6433da348a12e9ad0dd6ba90","643373178a12e9ad0d2fa45a","22/12/2022","8162/201","5","21","0 Months","55","0"
"6433da348a12e9ad0dd6ba91","643373178a12e9ad0d2fa45a","30/12/2022","8162/201","5","16","0 Months","55","0"